八音	擬音code	bàng-uâ-cê平話字
柳	l	l
邊	b	b
求	g	g
氣	k	k
低	d	d
波	p	p
他	t	t
曾	z	c
日	n	n
時	s	s
鶯		
蒙	m	m
語	ng	ng
出	c	ch
非	h	h
春公	ung	ung|ong
花瓜	ua	ua
香姜	iong	iong
秋周	iu	iu|eu
山干	ang	ang
開哉	ai	ai
嘉佳	a	a
賓京	ing	ing|eng
歡官	uang	uang
歌高	o	o̤
須車	y	ṳ|e̤ṳ
杯盃	uoi	uoi
孤姑	u	u|o
燈庚	eng	eng|aing
光	uong	uong
輝龜	ui	ui|oi
燒嬌	ieu	ieu
銀恭	yng	ṳng|e̤ṳng
釭綱	ong	ong|aung
之箕	i	i|e
東江	oeng	e̤ng|ae̤ng
郊交	au	au
過朱	uo	uo
西街	e	a̤
橋嬝	io	io
雞圭	ie	ie
聲正	iang	iang
催	oi	oi|o̤i
初梳	oe	e̤|ae̤
天堅	ieng	ieng
奇迦	ia	ia
歪乖	uai	uai
溝勾	eu	eu|aiu
桸𤬣	ya	
伓	ng	ng
上平	1	̆
上上	2	̄
上去	3	́
上入	4	́
下平	5	̀
下上	6	̄
下去	7	̂
下入	8	̆
